GSRN,cluster
570714700000000140,2
570714700000000157,2
570714700000000317,2
570714700000000324,2
570714700000000331,2
570714700000000348,0
570714700000000355,2
570714700000000362,2
570714700000000379,0
570714700000000966,0
570714700000002304,0
570714700000002311,0
570714700000002786,0
570714700000003134,2
570714700000003165,2
570714700000003219,2
570714700000003301,2
570714700000003318,2
570714700000003431,0
570714700000003585,1
570714700000004384,2
570714700000004469,1
570714700000004513,2
570714700000004520,3
570714700000004568,1
570714700000004575,3
570714700000004605,2
570714700000004704,1
570714700000004728,1
570714700000004735,2
570714700000004742,2
570714700000004759,2
570714700000004810,1
570714700000004940,1
570714700000004964,1
570714700000004995,1
570714700000005039,1
570714700000005053,1
570714700000005060,1
570714700000005091,1
570714700000005107,0
570714700000005114,2
570714700000005121,0
570714700000005138,0
570714700000005213,2
570714700000005282,2
570714700000005299,2
570714700000005305,2
570714700000005350,2
570714700000005381,2
570714700000005404,0
570714700000005428,0
570714700000005435,2
570714700000005442,2
570714700000005466,0
570714700000005503,1
570714700000005886,1
570714700000006029,1
570714700000006258,1
570714700000006289,1
570714700000006296,1
570714700000007828,1
570714700000008252,1
570714700000008450,1
570714700000008764,1
570714700000009648,2
570714700000009655,2
570714700000009662,0
570714700000009914,0
570714700000009938,0
570714700000009945,2
570714700000010590,0
570714700000010750,1
570714700000010767,1
570714700000010897,2
570714700000010989,2
570714700000011252,0
570714700000011269,2
570714700000011771,0
570714700000011788,0
570714700000011795,0
570714700000011801,0
570714700000011818,2
570714700000011825,2
570714700000011832,2
570714700000011849,2
570714700000011856,2
570714700000011863,2
570714700000011900,0
570714700000012242,0
570714700000012280,0
570714700000012297,0
570714700000012303,0
570714700000012327,2
570714700000012372,2
570714700000012389,2
570714700000012396,2
570714700000012402,2
570714700000012419,2
570714700000012495,0
570714700000012501,1
570714700000012518,0
570714700000012525,2
570714700000012563,2
570714700000012570,0
570714700000012631,0
570714700000012648,0
570714700000012792,0
570714700000012808,0
570714700000012815,0
570714700000012839,2
570714700000012846,3
570714700000013096,0
570714700000013102,2
570714700000013119,2
570714700000013126,2
570714700000013133,0
570714700000013188,0
570714700000013232,0
570714700000013249,0
570714700000013294,0
570714700000013300,0
570714700000013317,0
570714700000013324,2
570714700000013331,2
570714700000013348,2
570714700000013355,0
570714700000013362,2
570714700000013379,2
570714700000013386,0
570714700000013393,0
570714700000013409,0
570714700000013430,0
570714700000013515,2
570714700000013621,2
570714700000013812,0
570714700000013829,0
570714700000013836,2
570714700000013843,2
570714700000013881,0
570714700000013898,0
570714700000013904,2
570714700000013911,2
570714700000013928,0
570714700000014178,0
570714700000014284,2
570714700000014291,2
570714700000014307,2
570714700000014314,2
570714700000014321,0
570714700000014338,0
570714700000106682,0
570714700000106699,0
570714700000106958,1
570715000000083464,1
570715000000107078,2
571313174001764448,1
571313174116253585,2
