GSRN,cluster
570714700000004469,4
570714700000004476,2
570714700000004513,0
570714700000004568,4
570714700000004575,3
570714700000004605,0
570714700000004810,1
570714700000004964,1
570714700000005060,1
570714700000005213,0
570714700000106682,0
570714700000106699,0
570714700000106958,1
570715000000107078,0
571313174116253585,0
